@@@@@@@@@@@@@@@@@@@@@@@@@@@@@@@@@@@@@@@@
A..@@...@..@@@@@@@@....@...............@
@@....@@@@..........@@@@@@@@@@@@@@@.@@@@
@@.@@@@@...@@@@@@@....................@@
@...@....@@@...@@@@@@@@@@@@@@@@@@@@@..@@
@.@.@@.@@@...@...@@@......@@@.....@@@..@
@.@.@..@@..@@@@@.....@@@@.@@@.@@@....@.@
@.@.@.@@..@@..@@.@@@@@.@@.@@...@@.@@@@.@
@.@.@.@@@....@@@.@@@...@@....@.@@.@@@..@
@.@@@..@@@@@@@.....@.@..@@@.@@@@..@@..@@
@.@@@@..@@@....@@@@@.@@.@@@@@@...@@@.@@@
@....@@.....@@@@@....@@........@@@@....@
@@.@..@@@@@@@@....@@@@@@@..@@.@@@@@@@@.@
@@.@@@@@.......@@@@@......@@......@@.@.@
@...@@...@@@@@@@.....@@@@@@@@@@@@@@@.@.B
@.@.@@.@@@...@@@@@@@.......@@....@@@.@@@
@.@.@@@.@@.@.....@@@@@@@@@....@@.......@
@.@@@@@.@@@..@@@.........@@@@...@@@.@@@@
@.@...@.....@@@@@@@@@.@@......@@@@@....@
@.@.@.@@@.@@@@...@....@@@@@@@.@@@.@.@@.@
@...@.........@@...@@.....@.....@...@@.@
@@@@@@@@@@@@@@@@@@@@@@@@@@@@@@@@@@@@@@@@